0 0 R G B Y 0 0 0
0 R B G R B G Y 0
R G B Y R G B Y R
B R G B R G Y B R
G B Y G R B G Y R
R Y B R G B Y R G