R G B Y P O R G B
G B R G B R G B R
B Y G R B Y G R B
Y R B G Y R B G Y
R B Y G R B Y G R