P O R G B Y P O R
R G B Y P O R G B
B R G B R G Y B R
G B Y G R B G Y R
Y G B R Y G B R Y