P O R G B Y P O R
R G B Y P O R G B
G R B G R B Y G R
B G R B R Y G R B
Y B G R Y B R G Y
R Y G B R Y G B R
G B R G B R G B R
B R Y G B R Y G B
R G B R G B R G R