P P R R G G B B Y
R G B Y P O R G B
B R G B R G Y B R
G B R G B Y R G B
Y G B R Y G B R Y